32 208 14 255 
0 0 0 1 0 0 1 0 2 0 2 0 2 0 0 0 0 0 0 1 1 0 2 0 2 0 2 0 2 0 2 0 2 0 2 0 2 0 2 0 0 0 0 0 0 0 0 0 0 0 0 1 0 0 0 0 0 1 0 1 0 0 0 0 0 0 0 0 0 0 0 1 0 0 0 0 0 1 1 0 2 0 0 0 0 1 3 4 5 4 5 4 5 4 5 4 5 4 5 4 5 4 5 4 5 4 5 4 5 4 5 4 5 4 5 4 5 4 5 4 5 4 5 4 5 4 5 4 5 4 5 4 5 4 5 4 5 4 5 4 5 4 5 4 5 4 5 4 5 4 5 4 5 4 5 4 5 4 5 4 5 4 5 4 5 4 5 4 5 4 5 4 5 4 5 4 5 4 5 4 5 4 5 4 5 4 5 4 5 4 5 4 5 4 5 4 5 6 7 0 0 0 0 0 0 0 0 0 
8 8 8 0 8 8 2 9 10 11 0 9 10 11 0 9 8 8 8 0 2 9 10 11 0 9 10 11 0 9 10 11 0 9 10 11 0 9 10 11 0 9 0 0 8 8 0 0 8 8 8 0 0 0 8 8 8 0 8 0 0 0 8 8 0 0 0 0 0 0 8 0 8 8 0 0 8 0 2 9 10 11 0 9 8 0 12 13 14 13 14 13 14 13 14 13 14 13 14 13 14 13 14 13 14 13 14 13 14 13 14 13 14 13 14 13 14 13 14 13 14 13 14 13 14 13 14 13 14 13 14 13 14 13 14 13 14 13 14 13 14 13 14 13 14 13 14 13 14 13 14 13 14 13 14 13 14 13 14 13 14 13 14 15 14 15 14 15 14 15 14 15 14 15 14 15 14 15 14 15 14 15 14 15 14 15 14 15 14 15 14 15 14 15 14 15 14 16 17 18 0 0 0 0 0 0 0 0 
0 19 0 10 0 10 0 20 21 22 23 20 21 22 23 10 0 10 0 10 0 20 21 22 23 20 21 22 23 20 21 22 23 20 21 22 23 20 21 22 23 10 0 0 0 19 0 0 0 10 0 10 0 0 0 19 0 10 0 10 0 0 0 10 0 1 0 1 0 0 0 10 0 10 0 0 0 10 0 20 21 22 23 10 0 10 24 25 26 25 26 25 26 25 26 25 26 25 26 25 26 25 26 25 26 25 26 25 26 25 26 25 26 25 26 25 26 25 26 25 26 25 26 25 26 25 26 25 26 25 26 25 26 25 26 25 27 28 26 25 26 25 26 25 26 25 26 25 26 25 26 25 26 25 26 25 26 25 26 25 26 25 29 30 31 30 31 30 31 30 31 30 31 30 31 30 31 30 31 30 31 30 31 30 31 30 31 30 31 30 31 30 31 30 31 30 31 30 32 33 7 0 34 35 0 0 0 0 
8 0 0 0 0 0 36 37 38 39 40 41 38 39 42 0 0 0 0 0 36 37 38 39 40 41 38 39 40 41 38 39 40 41 38 39 40 41 38 39 42 0 8 8 8 0 0 0 0 0 0 0 8 8 8 0 8 8 8 8 0 0 0 0 8 0 8 0 0 0 8 8 0 0 0 0 0 0 36 37 38 39 42 0 8 8 43 44 43 44 43 44 43 44 43 44 43 44 43 44 43 44 43 44 43 44 43 44 43 44 43 44 43 44 43 44 43 44 45 46 45 46 45 46 45 46 45 46 43 44 43 44 43 44 43 44 47 48 45 46 45 46 45 46 45 46 45 46 45 46 45 46 45 46 45 46 43 44 43 44 45 46 49 50 14 13 14 13 14 13 14 13 14 13 14 13 14 13 14 13 14 13 14 13 14 13 14 13 14 13 14 13 14 13 14 13 14 13 14 51 52 53 54 55 56 57 57 57 
0 10 58 59 59 60 59 61 58 59 59 62 58 63 58 59 59 60 59 60 59 60 59 61 58 64 59 60 59 65 59 61 66 62 58 59 59 65 59 67 58 59 59 68 59 68 59 61 0 0 0 1 0 10 0 10 58 69 59 68 59 60 59 60 59 70 0 10 0 0 0 10 0 0 58 59 59 60 59 60 59 60 59 60 59 70 71 72 73 72 73 72 73 72 73 72 73 72 73 72 73 72 73 72 73 72 73 72 73 72 73 72 73 72 73 72 73 72 45 46 45 46 45 46 45 46 45 46 71 72 73 72 73 72 73 72 74 75 45 46 45 46 45 46 45 46 45 46 45 46 45 46 45 46 45 46 71 72 73 72 45 46 76 77 26 25 26 25 26 25 26 25 26 25 26 25 26 25 26 25 26 25 26 25 26 25 26 25 26 25 26 25 26 25 26 25 26 25 26 25 78 79 80 81 82 83 83 83 
0 0 84 85 86 87 88 89 84 85 86 89 84 90 84 85 86 87 88 87 88 87 88 89 84 85 86 87 88 87 88 89 88 89 84 85 86 87 88 91 84 85 86 87 88 87 88 89 0 0 8 0 0 0 0 0 84 85 86 87 88 87 88 87 88 89 0 0 0 0 0 0 0 0 84 85 86 87 88 87 88 87 88 87 88 92 93 94 95 94 95 94 95 94 95 94 95 94 95 94 95 94 95 94 95 94 95 94 95 94 95 94 95 94 95 94 95 96 43 44 43 44 43 44 43 44 43 44 97 94 95 94 95 94 95 94 95 96 45 46 43 44 43 44 45 46 45 46 45 46 45 46 45 46 43 44 97 94 95 96 45 46 43 44 43 44 45 46 45 46 45 46 45 46 45 46 45 46 45 46 45 46 45 46 45 46 45 46 43 44 43 44 43 44 43 44 45 46 45 46 45 98 99 100 82 83 83 83 
0 0 71 101 102 103 104 105 73 101 104 105 73 72 73 101 102 103 102 103 102 103 104 105 73 101 102 103 102 103 104 106 104 105 73 101 102 103 102 103 73 101 102 103 102 103 104 105 107 107 107 108 107 107 107 107 109 101 102 103 102 103 102 103 104 105 107 107 107 107 107 107 107 107 109 101 102 103 102 103 102 103 102 103 104 105 110 111 112 111 113 114 113 114 113 114 113 114 113 114 113 114 115 116 113 114 113 114 113 114 113 114 113 114 115 116 117 118 73 72 73 72 73 72 73 72 73 72 110 111 113 114 113 114 113 114 113 119 45 46 71 72 73 72 45 46 45 46 45 46 45 46 45 46 71 72 110 111 113 119 45 46 71 72 73 72 45 46 45 46 45 46 120 121 45 46 45 46 45 46 45 46 45 46 45 46 45 46 71 72 73 72 73 72 73 72 45 46 45 46 45 122 123 124 82 83 83 83 
0 0 97 94 95 94 95 94 95 94 95 94 95 94 95 94 95 94 95 94 95 94 95 94 95 94 95 94 95 94 95 94 95 94 95 94 95 94 95 94 95 94 95 94 95 94 95 96 125 126 127 128 127 128 127 129 130 94 95 94 95 94 95 94 95 96 125 126 127 128 127 128 127 129 130 94 95 94 95 94 95 94 95 94 95 94 95 94 95 131 132 133 134 133 134 133 134 133 134 133 134 135 136 137 138 133 134 133 134 133 134 133 134 135 136 137 139 94 95 94 95 94 95 94 95 94 95 94 95 131 132 133 134 133 134 133 134 135 43 44 97 94 95 96 45 46 43 44 43 44 45 46 45 46 97 94 95 131 132 135 45 46 97 94 95 96 43 44 43 44 43 44 47 140 45 46 45 46 45 46 45 46 45 46 43 44 43 44 97 94 95 94 95 94 95 96 43 44 45 46 45 141 142 143 82 83 83 83 
144 144 145 114 113 114 113 114 113 114 146 111 112 111 112 111 113 114 113 114 147 116 113 114 113 114 146 111 112 111 113 114 113 114 113 114 113 114 113 114 113 114 113 114 113 114 113 148 149 150 150 150 150 150 150 151 145 114 113 114 113 114 113 114 113 148 149 150 150 150 150 150 150 151 145 114 113 114 115 116 113 114 113 114 113 114 113 114 113 114 113 152 113 152 113 152 113 152 147 153 117 154 155 156 157 158 112 158 112 158 112 158 112 154 159 160 161 114 113 114 113 114 113 114 113 114 113 114 162 163 113 152 113 152 113 152 146 164 73 72 110 111 113 119 45 46 71 72 73 72 45 46 45 46 145 114 113 114 113 165 45 46 145 114 146 118 73 72 73 72 73 72 74 166 45 46 45 46 45 46 45 46 45 46 71 72 73 72 145 114 113 114 113 114 113 167 71 72 45 46 45 168 169 170 171 172 172 172 
173 173 138 133 134 133 134 133 134 174 175 94 95 94 95 131 132 133 134 135 176 177 138 133 134 174 175 94 95 131 132 133 134 133 134 133 134 133 134 178 179 180 181 180 181 180 182 135 173 173 173 173 173 173 173 173 138 133 134 133 134 133 134 133 134 135 173 173 173 173 173 173 173 173 138 133 134 135 136 137 138 133 134 133 134 133 134 133 134 133 134 133 134 178 179 180 181 183 176 177 139 94 95 94 95 94 95 94 95 94 95 94 95 131 132 133 134 133 134 133 134 133 134 133 134 133 134 135 47 48 138 178 179 180 182 174 175 94 95 94 95 131 132 135 45 46 97 94 95 96 43 44 43 44 138 133 134 178 179 183 45 46 138 174 175 94 95 94 95 94 95 94 95 96 45 46 45 46 43 44 43 44 45 46 97 94 95 131 132 178 179 180 181 180 181 183 97 96 43 44 45 184 185 186 82 187 187 187 
173 188 189 152 113 152 113 152 113 152 113 114 113 114 113 114 146 158 113 190 159 160 191 158 113 152 113 114 113 114 113 152 113 152 113 152 113 152 113 165 192 193 194 193 194 195 145 196 197 173 173 173 173 173 173 188 189 152 113 152 113 152 113 152 113 196 197 173 173 173 173 173 173 188 189 152 113 190 159 160 161 152 113 152 113 152 113 152 113 152 113 152 113 165 192 193 194 198 159 160 161 114 113 114 113 114 113 114 113 114 113 114 113 114 113 152 113 152 113 152 146 158 112 158 113 152 146 154 199 75 145 165 192 195 145 152 113 114 113 114 113 114 147 200 45 46 145 114 146 118 73 72 73 72 145 152 113 165 192 201 45 46 145 152 113 114 113 114 113 114 113 114 113 119 45 46 45 46 71 72 73 72 45 46 145 114 115 116 113 165 192 193 194 193 202 203 145 167 71 72 45 204 205 206 82 83 83 83 
173 207 208 209 210 209 210 209 210 211 182 133 134 133 134 174 175 131 132 133 134 174 175 212 213 211 182 133 134 178 214 209 210 209 210 211 182 133 134 133 134 133 134 133 134 178 214 215 216 173 173 173 173 173 173 207 208 209 210 209 210 209 210 209 210 215 216 173 173 173 173 173 173 207 208 209 210 211 182 133 134 133 134 133 134 133 134 133 134 133 134 133 134 133 134 133 134 178 214 211 182 133 134 133 134 133 134 133 134 133 134 133 134 133 134 133 134 133 134 174 175 94 95 131 132 174 175 94 95 131 132 133 134 133 134 133 134 133 134 133 134 135 176 177 45 46 138 174 175 94 95 94 95 131 132 133 134 133 134 135 45 46 138 133 134 133 134 133 134 133 134 133 134 135 43 44 45 46 97 94 95 96 45 46 138 135 136 137 138 133 134 133 134 135 136 137 138 174 175 96 43 217 218 219 82 83 83 83 
173 173 173 173 173 173 173 173 173 220 221 222 223 222 223 222 223 224 225 158 112 158 223 226 227 220 221 222 223 228 227 173 173 173 173 220 221 229 225 158 112 158 223 222 223 228 227 173 173 173 173 173 173 173 173 173 173 173 173 173 173 173 173 173 173 173 173 173 173 173 173 173 173 173 173 173 173 220 221 222 223 222 223 222 223 222 223 229 225 158 112 158 112 158 223 222 223 228 227 220 221 222 223 222 223 222 223 229 225 158 112 158 112 158 112 158 112 158 112 158 113 114 113 114 113 152 113 114 113 114 113 152 113 152 113 152 113 152 113 152 113 190 159 160 45 46 230 158 113 114 113 114 113 114 113 152 146 158 113 165 45 46 145 152 113 152 113 152 113 152 146 158 112 164 73 72 45 46 145 114 113 119 45 46 145 190 159 160 191 158 112 158 112 154 155 156 157 158 112 118 231 232 233 234 235 83 83 83 
173 173 173 173 173 173 173 173 173 173 173 173 173 173 173 173 173 236 237 238 239 240 241 173 173 173 173 173 173 173 173 173 173 173 173 173 173 236 237 238 239 240 241 173 173 173 173 173 173 173 173 173 173 173 173 173 173 173 173 173 173 173 173 173 173 173 173 173 173 173 173 173 173 173 173 173 173 173 173 173 173 173 173 173 173 173 173 236 237 238 239 238 239 240 241 173 173 173 173 173 173 173 173 173 173 173 173 236 237 238 242 243 244 243 244 243 244 243 244 245 246 247 248 247 248 247 248 247 248 247 248 247 248 247 248 247 248 247 248 247 248 247 248 249 45 46 250 245 246 247 248 247 248 247 248 251 252 245 246 249 45 46 253 247 248 247 248 247 248 251 252 243 244 243 244 254 45 46 253 247 248 249 45 46 253 247 248 251 252 243 244 243 244 243 244 243 244 243 244 243 244 243 255 82 187 83 83 83 
